NO textures/murs/sifi0.xpm
SO textures/murs/sifi1.xpm
WE textures/murs/sifi2.xpm
EA textures/murs/sifi3.xpm

F 75,68,63
C 0,0,0

1

11111111111111111111111111111111111111111111111111111111111111111111111111111111111111111
1000000001000000M00110000000M00X0110000X000010000D00000D0000000100000000Z0000100000000001
100000000D0000000Z0000111111111D111000000000D0000100000100Z0000M11110M0M00000D00000000001
1111M21111D1121111D1121111111110011000Z00000100001000001000000010000000000000100000000001
1110010100000100000001000001111001100000000010000100000100MM000D000000X000000100000000E01
111000010010010000000M000000110011111D11111111D111111111112111111111121111111111114311111
1110000MM00100100000X0M000000110000D00000000000M111111111111111111111111111111111111111111
111000010010010000001210000011002111112111111111
100Z000000100000000Z1110Z0000D011
111111111111121111111111112111111
11
