NO textures/wolfenstein/color_stone.xpm
SO textures/wolfenstein/red_brick.xpm
WE textures/wolfenstein/wood.xpm
EA textures/wolfenstein/mossy.xpm

F 75,68,63
C 0,0,30

1111111111111111111111111111111111111111111111111111111111111111111111111111111111111
1000000001000000000110000000000001100000000010000D00000000000001000000000000010000001
111111110000M000Z00000111111111DD11000000000100001000000Z00000010000000000000D0000001
111111111111111111111111111111100110000000Z010000100000000000001000000000000010000001
111000000000000000000000000111100110000000001000010000000000000D000000000000010000001
1110000000000000000000000000110011111D11111111D11111111111111111111111111111111111111
1110000000000Z00000000000000111000D00Z0000000001
111000000000000000000000000011000111111111111111
10E00000000000000000000000000D011
111111111111111111111111111111111