NO textures/murs/sifi0.xpm
SO textures/murs/sifi1.xpm
WE textures/murs/sifi2.xpm
EA textures/murs/uh.xpm

F 75,68,63
C 0,0,30

1111111111111111111111111111111111111111111111111111111111111111111111111111111111111
1E0000000100M000000110000000M00X0110000X000010000D00000D0000Z00100000000X000010000001
100000000D00M0000X0000111111111D111000000000D0000100000100Z00001111111111111D0000001
1111111111D1111111D1111111111110011000000000100001000001000000010000000000000100000X1
11100Z0100000100000001000001111001100000000010000100000100000Z0D000000X00000010000001
1110000100100100000000000000110011111D11111111D11111111111111111111111111111111111111
1110000100100100000000000000111000D0000000000001
111000010010010000000100000011000111111111111111
10000000001000Z00000010000000D011
111111111111111111111111111111111